uncertain	negposs
unsure	negposs
improbable	negprob
unlikely	negprob
possible	poss_adj
hypothetical	poss_adj
questionable	poss_adj
consistent	poss_adj
potential	poss_adj
suspicious for	poss_adj
unclear	poss_adj
unknown	poss_adj
possibly	poss_adv
seemingly	poss_adv
potentially	poss_adv
maybe	poss_adv
perhaps	poss_adv
possibilities	poss_noun
possibility	poss_noun
question	poss_noun
questioned	poss_noun
questioning	poss_noun
questions	poss_noun
speculation	poss_noun
?	poss_noun
differential diagnosis	poss_noun
differential diagnoses	poss_noun
believe	poss_verb
believed	poss_verb
believes	poss_verb
believing	poss_verb
consider	poss_verb
considered	poss_verb
considering	poss_verb
considers	poss_verb
postulate	poss_verb
postulated	poss_verb
postulating	poss_verb
postulates	poss_verb
speculate	poss_verb
speculated	poss_verb
speculates	poss_verb
speculating	poss_verb
can	poss_modal
could	poss_modal
may	poss_modal
might	poss_modal
should	poss_modal
would	poss_modal
whether or not	poss_conj
whether	poss_conj
either	poss_conj
or	poss_conj
if	poss_conj
probable	prob_adj
likely	prob_adj
presumed	prob_adj
presumptive	prob_adj
apparent	prob_adj
preliminary	prob_adj
putative	prob_adj
suggestive of	prob_adj
probably	prob_adv
likely	prob_adv
presumably	prob_adv
apparently	prob_adv
reportedly	prob_adv
supposedly	prob_adv
must	prob_modal
appear	prob_verb
appeared	prob_verb
appearing	prob_verb
appears	prob_verb
seem	prob_verb
seemed	prob_verb
seems	prob_verb
seeming	prob_verb
estimate	prob_verb
estimated	prob_verb
estimates	prob_verb
estimating	prob_verb
hypothesize	prob_verb
hypothesized	prob_verb
hypothesizes	prob_verb
hypothesizing	prob_verb
implied	prob_verb
implies	prob_verb
imply	prob_verb
implying	prob_verb
propose	prob_verb
proposed	prob_verb
proposes	prob_verb
proposing	prob_verb
suggest	prob_verb
suggested	prob_verb
suggesting	prob_verb
suggests	prob_verb
support	prob_verb
supported	prob_verb
supporting	prob_verb
supports	prob_verb
suppose	prob_verb
supposed	prob_verb
supposes	prob_verb
supposing	prob_verb
suspect	prob_verb
suspected	prob_verb
suspecting	prob_verb
suspects	prob_verb
think	prob_verb
thinks	prob_verb
thinking	prob_verb
thought	prob_verb
implication	prob_noun
implications	prob_noun
suspicion	prob_noun
suspicions	prob_noun
suggestion	prob_noun
suggestions	prob_noun
hypothesis	prob_noun
hypotheses	prob_noun
r/o	test_tenseless
ro	test_tenseless
rule out	test_tenseless
ruling out	test_tenseless
test for	test
tested for	test
testing for	test
tests for	test
check for	test
checked for	test
checking for	test
checks for	test
evaluate for	test
evaluated for	test
evaluates for	test
evaluating for	test